,Title,City,Price(Rs),Tax+Charges(Rs),Total Price/night(Rs),Rating,Review,No of Reviews,Distance from Centre(km)
0,"The Hosteller Bangalore, Brigade Road",Bangalore,2793,335,3128,8.9,Fabulous ,154 ,1.1
1,VOVO PREMIER HOTEL,Bangalore,2025,243,2268,8.6,Fabulous ,327 ,2.7
2,Vera by Bisque Hebbal - Manyata Tech Park,Bangalore,2699,324,3023,8.7,Fabulous ,69 ,7.3
3,Regenta Inn Indiranagar Bangalore,Bangalore,3146,378,3524,8.3,Very good ,1051 ,4.2
4,Hotel Chetan International,Bangalore,1280,154,1434,6.9,Good ,767 ,2.6
5,"ITC Windsor, a Luxury Collection Hotel, Bengaluru",Bangalore,9000,1620,10620,8.2,Very good ,1369 ,2.6
6,"The Hosteller Bangalore, Koramangala",Bangalore,2692,325,3017,8.7,Fabulous ,79 ,4.7
7,Hyatt Centric MG Road Bangalore,Bangalore,6075,729,6804,7.9,Good ,1194 ,2.2
8,Collection O Hotel Blueberry Near 7D Voyage,Bangalore,1160,173,1333,8.0,Very good ,185 ,11.7
9,Yello! ITPL,Bangalore,1347,162,1509,8.0,Very good ,3 ,14.2
10,The Leela Bhartiya City Bengaluru,Bangalore,11000,1980,12980,9.1,Superb ,391 ,12.7
11,Radisson Blu Atria Bengaluru,Bangalore,6250,750,7000,8.1,Very good ,1542 ,1.7
12,The Oberoi Bengaluru,Bangalore,12000,2160,14160,9.3,Superb ,2072 ,1.8
13,Vivanta Bengaluru Residency Road,Bangalore,7500,900,8400,8.0,Very good ,937 ,0.8
14,Olive Electronic City - by Embassy Group,Bangalore,2514,302,2816,9.2,Superb ,203 ,16.2
15,Radisson Bengaluru City Center,Bangalore,8000,1440,9440,8.4,Very good ,1141 ,1.9
16,Narthaki Boutique Hotel,Bangalore,2030,244,2274,8.1,Very good ,111 ,2.7
17,The Curzon Court,Bangalore,2200,330,2530,7.4,Good ,127 ,0.7
18,Radisson Blu Bengaluru Outer Ring Road,Bangalore,9000,1620,10620,7.9,Good ,977 ,10.9
19,Bloom Hotel - Brookefield,Bangalore,3015,362,3377,8.7,Fabulous ,150 ,12
20,Tulip Inn Koramangala,Bangalore,3150,378,3528,7.7,Good ,245 ,5.2
21,Casa Cottage,Bangalore,4550,546,5096,8.1,Very good ,314 ,1.4
22,FabHotel Phoenix Resorts,Bangalore,2273,273,2546,7.3,Good ,368 ,0.6
23,Olive HAL 2nd Stage - by Embassy Group,Bangalore,2763,332,3095,8.6,Fabulous ,154 ,5.3
24,Renaissance Bengaluru Race Course Hotel,Bangalore,9000,1620,10620,8.6,Fabulous ,336 ,2.9
25,Olive Kalyan Nagar - By Embassy Group,Bangalore,2262,271,2533,7.2,Good ,264 ,6.3
26,Taj Yeshwantpur Bengaluru,Bangalore,7000,840,7840,8.7,Fabulous ,916 ,8.9
27,"Welcomhotel by ITC Hotels, Richmond Road, Bengaluru",Bangalore,8500,1530,10030,8.2,Very good ,2087 ,1.6
28,Hotel Sigma Suites,Bangalore,1350,162,1512,7.7,Good ,172 ,2.8
29,"ITC Gardenia, a Luxury Collection Hotel, Bengaluru",Bangalore,11700,2106,13806,8.5,Very good ,1325 ,1.2
30,Nalapad's Hotel Bangalore International - Managed by Olive,Bangalore,2500,300,2800,6.7,Good ,66 ,2.6
31,Collection O The Mass Residency By D2v,Bangalore,914,144,1058,4.5,Good ,13 ,5.9
32,Melange Luxury Serviced Apartments,Bangalore,5400,648,6048,8.1,Very good ,212 ,0.9
33,OYO Flagship Varcity Pearl Near Nexus Mall Koramangala,Bangalore,1010,155,1165,8.3,Very good ,163 ,5.4
34,Grand Mercure Bengaluru at Gopalan Mall - An Accor Brand,Bangalore,6999,840,7839,8.5,Very good ,950 ,6.6
35,FabHotel Corporate Crown Koramangala,Bangalore,1819,218,2037,8.9,Fabulous ,858 ,4.9
36,"Treebo Trend Blu Orchid - 4 Km Away From Chinnaswamy Stadium, Bangalore",Bangalore,2394,287,2681,7.8,Good ,568 ,4
37,Ramada Encore Domlur Bangalore,Bangalore,4000,480,4480,8.1,Very good ,508 ,4.9
38,Olive Rest House Road by Embassy Group,Bangalore,2357,283,2640,6.9,Good ,460 ,0.6
39,ABM Express Inn,Bangalore,1655,199,1854,7.2,Good ,223 ,2.8
40,Olive Indiranagar - By Embassy Group,Bangalore,2685,322,3007,7.7,Good ,1179 ,4.8
41,Taj MG Road Bengaluru,Bangalore,11000,1980,12980,8.7,Fabulous ,826 ,2
42,FabHotel The BTM Palace,Bangalore,1933,232,2165,8.8,Fabulous ,481 ,6.7
43,FabHotel GRK Comforts,Bangalore,1521,183,1704,8.3,Very good ,847 ,6.4
44,Royal Ace Boutique Hotel - Manyata Techpark,Bangalore,3060,367,3427,8.2,Very good ,112 ,7.4
45,Oakwood Residence Whitefield Bangalore,Bangalore,7000,840,7840,8.5,Very good ,256 ,16
46,Hotel Royal Orchid Bangalore,Bangalore,5501,660,6161,7.0,Good ,919 ,5
47,OYO PALMS INN ROOMS,Bangalore,371,79,450,7.8,Good ,164 ,6.9
48,ibis Bengaluru Hebbal - An Accor Brand,Bangalore,4700,564,5264,7.5,Good ,394 ,7.3
49,Melange Astris,Bangalore,4900,588,5488,7.2,Good ,286 ,1.4
50,"Fortune Select JP Cosmos, Bengaluru - Member ITC's hotel group",Bangalore,6599,792,7391,8.4,Very good ,534 ,1.6
51,Courtyard by Marriott Bengaluru Hebbal,Bangalore,9750,1755,11505,8.5,Very good ,82 ,7.4
52,Elysian Grand Hotel,Bangalore,2090,251,2341,8.1,Very good ,87 ,7.6
53,Super OYO Collection O Hotel Palm Tree,Bangalore,1738,260,1998,7.5,Good ,420 ,3
54,FabHotel The Royal Suites,Bangalore,1818,218,2036,5.7,Good ,37 ,6.6
55,Citadel Sarovar Portico Bengaluru,Bangalore,3034,364,3398,6.3,Good ,95 ,2.9
56,OYO Flagship Blooms Residency Near Baiyappanahalli Metro Station,Bangalore,1257,193,1450,7.8,Good ,1216 ,7
57,The Park Bangalore,Bangalore,5440,653,6093,7.5,Good ,302 ,1.9
58,Goldfinch Hotel Bangalore,Bangalore,5249,630,5879,7.6,Good ,276 ,2.6
59,Daffodil Delight,Bangalore,1844,221,2065,7.7,Good ,43 ,7.2
60,Super OYO Collection O Petals Otium Business Hotel,Bangalore,1018,156,1174,8.9,Fabulous ,967 ,10.7
61,FabHotel Crown Heights,Bangalore,2273,273,2546,8.1,Very good ,327 ,5
62,Treebo Trend Raj Elegance Nagavara,Bangalore,2105,253,2358,6.0,Good ,362 ,7.4
63,"Royal Orchid Central Bangalore, Manipal Centre, MG Road",Bangalore,4250,510,4760,8.6,Fabulous ,838 ,1.5
64,FabHotel Crown Suites,Bangalore,1705,205,1910,9.3,Superb ,72 ,5
65,Super OYO Townhouse OAK Spruce Hotels A2 Indiranagar,Bangalore,1800,217,2017,7.0,Good ,294 ,4.3
66,"Treebo Trend Apple Villa - 2 Km Away From Chinnaswamy Stadium, Bangalore",Bangalore,2298,276,2574,7.3,Good ,1887 ,2.3
67,ibis Bengaluru City Centre - An Accor Brand,Bangalore,3999,480,4479,8.2,Very good ,92 ,1.3
68,Laika Boutique Stay,Bangalore,4400,528,4928,8.1,Very good ,35 ,1.7
69,Modern Hotel,Bangalore,1320,158,1478,8.3,Very good ,125 ,3.2
70,Terrace Gardens,Bangalore,4500,540,5040,9.0,Superb ,6 ,1.4
71,Home Awaits 455,Bangalore,1650,198,1848,7.9,Good ,27 ,12.4
72,Super OYO Collection O 73977 Malleswaram,Bangalore,1925,265,2190,9.7,Exceptional ,4 ,3.7
73,Apart Hotel SRS,Bangalore,2240,269,2509,8.7,Fabulous ,1045 ,4.7
74,Shangri-La Bengaluru,Bangalore,16500,2970,19470,7.4,Good ,321 ,2.3
75,"Southern Star,Bangalore",Bangalore,5185,928,6113,7.9,Good ,148 ,4.4
76,Tristar Serviced Apartments,Bangalore,3750,450,4200,7.4,Good ,12 ,28.2
77,Krishna Homes,Bangalore,6800,816,7616,8.3,Very good ,1069 ,2.1
78,Conrad Bengaluru,Bangalore,15000,2700,17700,8.9,Fabulous ,118 ,9.8
79,Felix Inn - Manyata Tech Park,Bangalore,1650,198,1848,7.6,Good ,269 ,3.9
80,X by Bloom l Indiranagar,Bangalore,3690,443,4133,5.8,Good ,39 ,5.5
81,Hotel Monarch International Jayanagar,Bangalore,2249,270,2519,8.9,Fabulous ,300 ,4.9
82,FabHotel The Leela Park,Bangalore,2030,244,2274,7.4,Good ,1297 ,2.6
83,"Holiday Inn Bengaluru Racecourse, an IHG Hotel",Bangalore,6199,744,6943,8.0,Very good ,77 ,7.6
84,X by Bloom I Hebbal Manyata Park,Bangalore,2160,259,2419,7.6,Good ,586 ,5.4
85,Sterlings Mac Hotel,Bangalore,7820,1408,9228,7.6,Good ,64 ,6.2
86,Olive Golflinks - by Embassy Group,Bangalore,1898,228,2126,5.3,Good ,37 ,5.5
87,The Corporate Comforts,Bangalore,1650,198,1848,8.1,Very good ,306 ,4.4
88,Bloom Hotel - Indiranagar,Bangalore,5000,600,5600,7.7,Good ,184 ,5.7
89,Capital O Boulevard Elite Madiwala Near Ragigudda Sri Prasanna Anjanayeswamy Temple,Bangalore,1007,163,1170,6.6,Good ,93 ,3.4
90,Atlaantic Inn,Bangalore,1445,173,1618,8.2,Very good ,445 ,5.9
91,FabExpress Ivory Pearl,Bangalore,1249,150,1399,7.0,Good ,176 ,2.3
92,"Treebo Trend Trinitywood - 3 Km Away From Chinnaswamy Stadium, Bangalore",Bangalore,1815,218,2033,9.0,Superb ,413 ,5.3
93,FabHotel Greenwood Xpress,Bangalore,1750,210,1960,7.7,Good ,48 ,6.5
94,Capital O VMK Paradise,Bangalore,922,145,1067,8.9,Fabulous ,1854 ,5.3
95,The Leela Palace Bengaluru,Bangalore,17000,3060,20060,10,Exceptional ,3 ,10.1
97,ZEKE HOTELS,Bangalore,1890,227,2117,8.5,Very good ,167 ,3.3
98,Temple Tree Hotel,Bangalore,2880,346,3226,8.0,Very good ,712 ,19.6
99,"Holiday Inn Express & Suites Bengaluru Old Madras Road, an IHG Hotel",Bangalore,4049,486,4535,8.7,Fabulous ,3 ,3.1
100,Place with a cosy and homely feel,Bangalore,4200,504,4704,7.1,Good ,52 ,25.7
101,Treebo Trend SK Suites,Bangalore,1690,203,1893,8.3,Very good ,318 ,0.9
102,JW Marriott Hotel Bengaluru,Bangalore,15000,2700,17700,6.8,Good ,309 ,2.8
103,Hotel Embassy,Bangalore,990,119,1109,8.4,Very good ,16 ,16.4
104,ROYAL ACE LUXUR,Bangalore,2250,270,2520,6.9,Good ,67 ,2.8
105,Sri Durgamba Lodge,Bangalore,830,100,930,7.8,Good ,122 ,3.9
106,"Treebo Trend Raj Premier - 4 Km Away From Chinnaswamy Stadium, Bangalore",Bangalore,3511,421,3932,6.2,Good ,522 ,3.7
107,BNGV Mystic Premier Hotel,Bangalore,3640,437,4077,7.6,Good ,103 ,1.4
108,Utse Suites,Bangalore,2750,330,3080,7.9,Good ,292 ,6.2
109,Olive BTM Layout - By Embassy Group,Bangalore,2944,353,3297,3.4,Good ,5 ,11.9
110,2BHK Lux Home Manyata Airport Hennur Pool Gym BH02,Bangalore,3500,420,3920,7.0,Good ,444 ,2.5
111,Hotel Apple Suites,Bangalore,1800,216,2016,8.3,Very good ,294 ,4.9
112,FabHotel S Comfort Inn,Bangalore,1819,218,2037,7.9,Good ,53 ,13.3
113,Super OYO Collection O Global Stay Near Kengeri Bus Terminal Metro Station,Bangalore,1301,216,1517,7.5,Good ,2 ,16.2
114,TS Suites,Bangalore,1120,134,1254,7.0,Good ,84 ,2.7
115,Hotel U.T.ELITE,Bangalore,1530,184,1714,6.9,Good ,486 ,4.7
116,Fairfield by Marriott Bengaluru Rajajinagar,Bangalore,5650,678,6328,7.6,Good ,84 ,5.1
117,Lazdana Hotel Bangalore,Bangalore,4589,551,5140,8.1,Very good ,130 ,9.1
118,Super OYO Townhouse 258 Spruce Hotels Bellandur,Bangalore,1611,227,1838,8.2,Very good ,24 ,5.9
119,Astra Hotels and Suites - Koramangala,Bangalore,1999,240,2239,8.6,Fabulous ,89 ,8.8
120,Stayhome Suites,Bangalore,2330,280,2610,8.2,Very good ,530 ,5.9
121,Grand Mercure Bangalore - An Accor Brand,Bangalore,9700,1746,11446,8.1,Very good ,118 ,3.8
122,Olive Indiranagar Metro - by Embassy Group,Bangalore,3018,422,3440,10,Exceptional ,2 ,13.1
123,Luxurious 3BHK in 23rd floor of Bhartiya City,Bangalore,5400,648,6048,8.4,Very good ,50 ,4.4
